WWWWWWWDWWWWWWW
W             W
W   OOO       W
W   OOO   OO  W
W         O   W
W             W
W        OO   D
W  P      O   W
W         O   W
WWWWWWWWWWWWWWW